**PROGRAMMING INDEX**

Agile Software Development|agile_software_development.txt|0|Wikipedia article
Algorithm|algorithm.txt|0|Wikipedia article
Amazon Web Services|amazon_web_services.txt|0|Wikipedia article
Android Operating System|android_operating_system.txt|0|Wikipedia article
Angular Web Framework|angular_web_framework.txt|0|Wikipedia article
Apache Cassandra|apache_cassandra.txt|0|Wikipedia article
Api|api.txt|0|Wikipedia article
Artificial Intelligence|artificial_intelligence.txt|0|Wikipedia article
Assembly Language|assembly_language.txt|0|Wikipedia article
Big O Notation|big_o_notation.txt|0|Wikipedia article
Binary Tree|binary_tree.txt|0|Wikipedia article
Bitcoin|bitcoin.txt|0|Wikipedia article
Blockchain|blockchain.txt|0|Wikipedia article
Bootstrap Front End Framework|bootstrap_front_end_framework.txt|0|Wikipedia article
C|c.txt|0|Wikipedia article
C Programming Language|c_programming_language.txt|0|Wikipedia article
C Sharp Programming Language|c_sharp_programming_language.txt|0|Wikipedia article
Cloud Computing|cloud_computing.txt|0|Wikipedia article
Cobol|cobol.txt|0|Wikipedia article
Compiler|compiler.txt|0|Wikipedia article
Computer Network|computer_network.txt|0|Wikipedia article
Computer Security|computer_security.txt|0|Wikipedia article
Computer Virus|computer_virus.txt|0|Wikipedia article
Computer Vision|computer_vision.txt|0|Wikipedia article
Content Delivery Network|content_delivery_network.txt|0|Wikipedia article
Continuous Integration|continuous_integration.txt|0|Wikipedia article
Cryptocurrency|cryptocurrency.txt|0|Wikipedia article
Cryptography|cryptography.txt|0|Wikipedia article
Css|css.txt|0|Wikipedia article
Data Structure|data_structure.txt|0|Wikipedia article
Database|database.txt|0|Wikipedia article
Deep Learning|deep_learning.txt|0|Wikipedia article
Devops|devops.txt|0|Wikipedia article
Django Web Framework|django_web_framework.txt|0|Wikipedia article
Docker Software|docker_software.txt|0|Wikipedia article
Domain Name System|domain_name_system.txt|0|Wikipedia article
Elixir Programming Language|elixir_programming_language.txt|0|Wikipedia article
Encryption|encryption.txt|0|Wikipedia article
Erlang Programming Language|erlang_programming_language.txt|0|Wikipedia article
Ethereum|ethereum.txt|0|Wikipedia article
F Sharp Programming Language|f_sharp_programming_language.txt|0|Wikipedia article
File System|file_system.txt|0|Wikipedia article
Firewall Computing|firewall_computing.txt|0|Wikipedia article
Flask Web Framework|flask_web_framework.txt|0|Wikipedia article
Fortran|fortran.txt|0|Wikipedia article
Functional Programming|functional_programming.txt|0|Wikipedia article
Git|git.txt|0|Wikipedia article
Github|github.txt|0|Wikipedia article
Go Programming Language|go_programming_language.txt|0|Wikipedia article
Graph Theory|graph_theory.txt|0|Wikipedia article
Graphql|graphql.txt|0|Wikipedia article
Hash Table|hash_table.txt|0|Wikipedia article
Haskell|haskell.txt|0|Wikipedia article
Html|html.txt|0|Wikipedia article
Http|http.txt|0|Wikipedia article
Https|https.txt|0|Wikipedia article
Internet|internet.txt|0|Wikipedia article
Internet Protocol Suite|internet_protocol_suite.txt|0|Wikipedia article
Interpreter Computing|interpreter_computing.txt|0|Wikipedia article
Ios|ios.txt|0|Wikipedia article
Java Programming Language|java_programming_language.txt|0|Wikipedia article
Javascript|javascript.txt|0|Wikipedia article
Jquery|jquery.txt|0|Wikipedia article
Kernel Operating System|kernel_operating_system.txt|0|Wikipedia article
Kotlin|kotlin.txt|0|Wikipedia article
Kotlin Programming Language|kotlin_programming_language.txt|0|Wikipedia article
Kubernetes|kubernetes.txt|0|Wikipedia article
Linked List|linked_list.txt|0|Wikipedia article
Linux|linux.txt|0|Wikipedia article
Lisp Programming Language|lisp_programming_language.txt|0|Wikipedia article
Load Balancing Computing|load_balancing_computing.txt|0|Wikipedia article
Lua|lua.txt|0|Wikipedia article
Machine Learning|machine_learning.txt|0|Wikipedia article
Macos|macos.txt|0|Wikipedia article
Malware|malware.txt|0|Wikipedia article
Matlab|matlab.txt|0|Wikipedia article
Memory Management|memory_management.txt|0|Wikipedia article
Microservices|microservices.txt|0|Wikipedia article
Microsoft Windows|microsoft_windows.txt|0|Wikipedia article
Mongodb|mongodb.txt|0|Wikipedia article
Mysql|mysql.txt|0|Wikipedia article
Natural Language Processing|natural_language_processing.txt|0|Wikipedia article
Neural Network|neural_network.txt|0|Wikipedia article
Nodejs|nodejs.txt|0|Wikipedia article
Nosql|nosql.txt|0|Wikipedia article
Object Oriented Programming|object_oriented_programming.txt|0|Wikipedia article
Operating System|operating_system.txt|0|Wikipedia article
Pascal Programming Language|pascal_programming_language.txt|0|Wikipedia article
Perl|perl.txt|0|Wikipedia article
Php|php.txt|0|Wikipedia article
Postgresql|postgresql.txt|0|Wikipedia article
Process Computing|process_computing.txt|0|Wikipedia article
Prolog|prolog.txt|0|Wikipedia article
Public Key Cryptography|public_key_cryptography.txt|0|Wikipedia article
Python Programming Language|python_programming_language.txt|0|Wikipedia article
Pytorch|pytorch.txt|0|Wikipedia article
Queue Abstract Data Type|queue_abstract_data_type.txt|0|Wikipedia article
R Programming Language|r_programming_language.txt|0|Wikipedia article
React Software|react_software.txt|0|Wikipedia article
Recursion|recursion.txt|0|Wikipedia article
Redis|redis.txt|0|Wikipedia article
Reinforcement Learning|reinforcement_learning.txt|0|Wikipedia article
Relational Database|relational_database.txt|0|Wikipedia article
Rest|rest.txt|0|Wikipedia article
Ruby On Rails|ruby_on_rails.txt|0|Wikipedia article
Ruby Programming Language|ruby_programming_language.txt|0|Wikipedia article
Rust Programming Language|rust_programming_language.txt|0|Wikipedia article
Scala Programming Language|scala_programming_language.txt|0|Wikipedia article
Scrum Software Development|scrum_software_development.txt|0|Wikipedia article
Search Engine|search_engine.txt|0|Wikipedia article
Server Computing|server_computing.txt|0|Wikipedia article
Sorting Algorithm|sorting_algorithm.txt|0|Wikipedia article
Spring Framework|spring_framework.txt|0|Wikipedia article
Sql|sql.txt|0|Wikipedia article
Sqlite|sqlite.txt|0|Wikipedia article
Stack Abstract Data Type|stack_abstract_data_type.txt|0|Wikipedia article
Swift Programming Language|swift_programming_language.txt|0|Wikipedia article
Tensorflow|tensorflow.txt|0|Wikipedia article
Typescript|typescript.txt|0|Wikipedia article
Unix|unix.txt|0|Wikipedia article
Version Control|version_control.txt|0|Wikipedia article
Virtual Machine|virtual_machine.txt|0|Wikipedia article
Vuejs|vuejs.txt|0|Wikipedia article
Web Browser|web_browser.txt|0|Wikipedia article
Websocket|websocket.txt|0|Wikipedia article

=======================================
Total: 125 articles
